####################
#..................#
#..................#
#..................#
#..................#
######.............#
     #.............#
     #.............#
     #.............#
######.............#
#..................#
#..................#
#..................#
#........###########
#........#          
#..###...###########
#..# #.............#
#..###.............#
#..................#
####################