####################
#..................#
#...B..............#
#..................#
#..................#
######.............#
     #.............#
     #...B....G....#
     #...B.........#
######...B.........#
#............CC....#
#............CC....#
#..................#
#...C....###########
#........#          
#..###...###########
#..# #.............#
#..###.............#
#..................#
####################